00,00,00,00,00,00,00,00,00,00
00,01,01,01,01,01,01,01,01,00
00,01,02,02,02,02,02,02,01,00
00,01,02,03,03,03,03,02,01,00
00,01,02,03,00,00,03,02,01,00
00,01,02,03,00,00,03,02,01,00
00,01,02,03,03,03,03,02,01,00
00,01,02,02,02,02,02,02,01,00
00,01,01,01,01,01,01,01,01,00
00,00,00,00,00,00,00,00,00,00
